##########
#.....#E##
#.M...#S.#
#........#
#P.......#
##########