#############
#E#.........#
##..........#
#.###.......#
#..E#.......#
#.###.......#
#.#.........#
#P..........#
#############
