##########
#...M..#E#
#......###
#........#
#P....S..#
##########