############E
#..........#S
#..........#M
#...........#
#P..........#
#############
